Semi-Charmed Life - Third Eye Blind
Mr. Jones - Counting Crows
Two Princes - Spin Doctors
Closing Time - Semisonic
Save Tonight - Eagle Eyed Cherry
Push - Matchbox Twenty
One Headlight - The Wallflowers
Hey Jealousy - Gin Blossoms
I'm Gonna Be (500 Miles) - The Proclaimers
Good - Better Than Ezra
If You Could Only See - Tonic
You Get What You Give - New Radicals
Lump - The Presidents of the United States of America
Someday - Sugar Ray
All I Want - Toad the Wet Sprocket
Laid - James
Selling The Drama - Live
My Own Worst Enemy - Lit
In The Meantime - Spacehog
Barely Breathing - Duncan Sheik
The Way - Fastball
Everything You Want - Vertical Horizon
Dyslexic Heart - Paul Westerberg
What's My Age Again? - blink-182
No Rain - Blind Melon
Virtual Insanity - Jamiroquai
Got You (Where I Want You) - The Flys
High - Feeder
What's Up? - Four Non Blondes
Shimmer - Fuel
How Bizarre - OMC
She's So High - Tal Bachman
Runaway Train - Soul Asylum
Alright - Supergrass
Bitter Sweet Symphony - The Verve
Don't Speak - No Doubt
Right Here Right Now - Jesus Jones
Crazy For This Girl - Evan and Jaron
One Week - Barenaked Ladies
Sex And Candy - Marcy Playground
Send Me On My Way - Rusted Root
Feed The Tree - Belly
Why I'm Here - Oleander
Beautiful Girl - INXS
That Was A Crazy Game Of Poker - OAR
Losing My Religion - REM
Unbelievable - EMF
Little Black Backpack - Stroke 9
Teenage Dirtbag - Wheatus
Come Out And Play - The Offspring
All Star - Smash Mouth
Absolutely (Story Of A Girl) - Nine Days
Roll To Me - Del Amitri
Inside Out - Eve 6
Blister In The Sun - Violent Femmes
Cannonball - The Breeders
Iris - The Goo Goo Dolls
Into Your Arms - The Lemonheads
Mmmm Mmmm Mmmm Mmmm - Crash Test Dummies
Santa Monica - Everclear
Shine - Collective Soul
Run-Around - Blues Traveler
All For You - Sister Hazel
Linger - The Cranberries
Ironic - Alanis Morissette
Breakfast At Tiffany's - Deep Blue Someday
Crash Into Me - Dave Matthews Band
Counting Blue Cars - Dishwalla
One Man Army - Our Lady Peace
Lovefool - The Cardigans
Stupid Girl - Garbage
The Freshman - The Verve Pipe
Glycerine - Bush
The Distance - Cake
The Impression That I Get - The Mighty Mighty Bosstones
Far Behind - Candlebox
Buddy Holly - Weezer
What I Got - Sublime
Kiss Me - Sixpence None The Richer
Closer To Fine - Indigo Girls
Life Is A Highway - Tom Cochrane
Fade Into You - Mazzy Star
Friday I'm In Love - The Cure
High And Dry - Radiohead
Loser - Beck
She Don'tUse Jelly - The Flaming Lips
Everything About You - Ugly Kid Joe
Everything Falls Apart - Dog's Eye View
Freak Of The Week - Marvelous 3
Better Days (And The Bottom Drops Out) - Citizen King
Bound For The Floor - Local H
Novacaine For The Soul - Eels